V: 0.02
Name: The Norm
Desc: The norm is a huge labyrinth you need to workaround just because someone thought it would make us better coders. I don't know about that...
Next: 2.map
1111111111111111111111111111111
1          3               3  1
1  6:START;       3        3      3  1
1       3  3        3         1
333333333  3 33 3333333333    1
1          3    3             1
1          3    3    3  3333  1
1          3    3    3  3  33 1
1   33333333  3 3   3         1
1            3      3         1
1      3    33      3 3   3   1
1     33   33      33 3   3   1
1333333   33       3  3   3   1
1       333     3  3  3  3    1
1      33      3   3 3   3    1
1      3      3    3 3        1
1  3         3       3   3    1
1  3        3           3     1
1   3      3   3        3     1
1   33    3   3       33      1
1        3  33        3       1
1       33 33     33          1
1      33  3    333           1
1  33  3       3              1
1   3         3               1
1   33       3  3333333333333 1
1    3       3                1
1     3      33       3       1
1     3       3       3       1
1                     3 7:END;     1
1111111111111111111111111111111
