V: 0.02
Name: C
Desc: The C-language is a powerful one, it can shape the very fabric of reality! But it comes with ait's own curses... Endless oceans of TRASH! No one wants you!! They just want that new Javascript library!!! P.S. Don't look at the map in the editor. It is very cursed
Next: 2.map
1111111111111111111111111111111
1        1   1 1   1          1
1 11 111 11111 11111 1111 111 1
1 1    1             1      1 1
1 1    1 11111 11111 1        1
1      1 1   1 1   1 17:END;     1 1
1 1  111 1   1 1   1 111    1 1
1 1  1                 1    1 1
1 1111 1111 11111 1111 111111 1
1      1    1   1    1        1
11 111 1    1   1    1 111 11 1
 1 1   1             1   1 1  1
 1 1       111 111       1 1  1
 1 1   111 1     1 111   1 1  1
11 111 1   1     1   1 111 11 1
1      1      6:START;      1        1
11 111 1   1     1   1 111 11 1
 1 1   111 1     1 111   1 1  1
 1 1       111 111       1 1  1
 1 1   1             1   1 1  1
11 111 1    1   1    1 111 11 1
1      1    1   1    1        1
1 1111 1111 11111 1111  11111 1
1 1  1                  1   1 1
1 1  111 1   1 1   1 1111   1 1
1      1 1   1 1   1 1        1
1 1    1 11111 11111 1      1 1
1 1    1             1      1 1
1 11 111 11111 11111 111 1111 1
1        1   1 1   1          1
1111111111111111111111111111111
